1111111111111111111111111111111111
110S00000000000C100S00000000H00001
1010010100100000C01001000000010101
101001001010101CPC100C00000H0E0101
10S000V00C00C000C0000S0000000S0011
1111111111111111111111111111111111
