1111111111111111111111111111111111
1E0000000000000C100000001000000001
1010010100100000C01001000000010101
101001001010101CPC100100000H010101
100000000C00C000C0000S0000000S0011
1111111111111111111111111111111111
