1111111111111111111111111111111111
1E0000000000000C00000C000000000001
1010010100100000C01001000000010101
101001001010101CPC1001000000010101
100000000C00C000C000000000000000C1
1111111111111111111111111111111111
