11111111
100P1111
1C0E00E1
11111111