11111111
100P1111
1C0C10E1
11111111