11111111
100P1111
1C0C00E1
11111111