11111111
100P1111
1C00E0E1
11111111