11111111
100P1111
1C0E0001
11111111