1111111111111111111111111111111111
1000000000000000000000000000000011
1010010100100001001001000000010101
1010010010101010001001000000010101
1P0C000000000000000000000000000001
1111111111111111111111111111111111