1111111111111111111111111111111111
1E0000000000000S0000000S00C0000011
11100101001S0001001001000000010101
101001001010101000100100000C010101
1P0C0000000000000000C00S0000000001
1111111111111111111111111111111111