1111111111111111111111111111111111
1E0000000000000S0000000S0000000011
1110010100100001001001000000010101
1010010010101010001001000000010101
1P0C0000000000000000000S0000000001
1111111111111111111111111111111111