11111111111111111111111111111111111
1E0000V00000000S0000000S00C00000111
11100101001S0001001001000V000101011
101001001010101000100100000C0101011
1P0C0000000000000000C00S00000000011
101001001010101000100100000C0101011
10100100101010100010010000000101011
10H000001010101000100H0000000001011
101S01001010101000100100000C0101011
11111111111111111111111111111111111