1111111111111111111111111111111111
100000000000000C00000C000000000001
10100101001000001010010000000E0101
1010010010101010001001000000000101
1P0000000C00C0000000000000000000C1
110000000C00C0000000000000000000C1
110000000C00C0000000000000000000C1
1111111111111111111111111111111111
