1111111111111111111111111111111111
1PCCCCCCCCCCCCCCCC0CCCCCCCCCCCCCE1
1CCCCCCCCCCCCCCCCCCCCCCCCCCCCCCCC1
1CCCCCCCCCCCCCCCCCCCCCCCCCCCCCCCC1
1CCCCCCCCVCCCCCCCCCCCCCCCCCCCCCCC1
1CCCCCCCCCCCCCCCCCCHCCCCCCCCCCCCC1
1CCCCCCCCCCCCCCCCCCCCCCCCCVCCCCCC1
1CCCCCCCCCCCCCCCCCCCCCCCCCCCCCCCH1
1CCCCCCCCCCCCCCCCCCCCCCCCCCCCCCCC1
1CCCCCCCCVCCCCCCCCCCCCCCCCCCCCCCC1
1CCCCCCCCCCCCCCCCCCHCCCCCCCCCCCCC1
1CCCCCCCCCCCCCCCCCCCCCCCCCVCCCCCC1
1CCCCCCCCCCCCCCCCCCCCCCCCCCCCCCCH1
1111111111111111111111111111111111
