1111111111111111111111111111111111
100000V00000000S0000000S00C0000011
11100101001S0001001001000V00010101
101001001010101000100100000C010101
1P0C0000000000000000C00S0000000001
101001001010101000100100000C010101
1010010010101010001001000000010101
10H000001010101000100H000000001111
101S01001010101000100100000C01E1C1
1111111111111111111111111111111111